41 30 
0 0
31 31 31 31 31 31 31 31 31 31 31 31 31 31 31 31 31 31 31 31 31 31 31 31 31 31 31 31 31 31 31 31 31 31 31 31 31 31 31 31 31
31 31 31 31 31 31 31 31 31 31 31 31 31 31 31 31 31 31 31 31 31 31 31 31 31 31 31 31 31 31 31 31 31 31 31 31 31 31 31 31 31
31 31 31 31 31 31 31 31 31 31 31 31 31 31 31 31 31 31 31 31 31 31 31 31 31 31 31 31 31 31 31 31 31 31 31 31 31 31 31 31 31
31 31 31 31 31 31 31 31 31 31 31 31 31 31 31 31 31 31 31 31 31 31 31 31 31 31 31 31 31 31 31 31 31 31 31 31 31 31 31 31 31
31 31 31 31 31 31 31 31 31 31 31 31 31 31 31 31 31 31 31 31 31 31 31 31 31 31 31 31 31 31 31 31 31 31 31 31 31 31 31 31 31
31 31 31 31 31 31 31 31 31 31 31 31 31 31 31 31 31 31 31 31 31 31 31 31 31 31 31 31 31 31 31 31 31 31 31 31 31 31 31 31 31
31 31 31 31 31 31 31 31 31 31 31 31 31 31 31 31 31 31 31 31 31 31 31 31 31 31 31 31 31 31 31 31 31 31 31 31 31 31 31 31 31
31 31 31 31 31 31 31 31 31 31 31 31 31 31 31 31 31 31 31 31 31 31 31 31 31 31 31 31 31 31 31 31 31 31 31 31 31 31 31 31 31
31 31 31 31 31 31 31 31 31 31 31 31 31 31 31 31 31 31 31 31 31 31 31 31 31 31 31 31 31 31 31 31 31 31 31 31 31 31 31 31 31
31 31 31 31 31 31 31 31 31 31 31 31 31 31 31 31 31 31 31 31 31 31 31 31 31 31 31 31 31 31 31 31 31 31 31 31 31 31 31 31 31
31 31 31 31 31 31 31 31 31 31 31 31 31 31 31 31 31 31 31 31 31 31 31 31 31 31 31 31 31 31 31 31 31 31 31 31 31 31 31 31 31
31 31 31 31 31 31 31 31 31 31 31 31 31 31 31 31 31 31 31 31 31 31 31 31 31 31 31 31 31 31 31 31 31 31 31 31 31 31 31 31 31
31 31 31 31 31 31 31 38 33 78 33 33 33 33 33 33 33 33 33 33 33 33 33 33 33 33 39 31 31 31 31 31 31 31 31 31 31 31 31 31 31
31 31 31 31 31 31 31 36 37 72 72 72 72 72 72 72 72 72 72 72 72 72 72 72 72 72 35 31 31 31 31 31 31 31 31 31 31 31 31 31 31
31 31 31 31 31 31 31 36 37 77 31 31 31 31 32 32 32 32 32 32 32 32 32 32 32 75 35 31 31 31 31 31 31 31 31 31 31 31 31 31 31
31 31 31 31 31 31 31 36 37 77 31 31 31 31 32 32 32 69 32 69 32 32 69 32 69 75 35 31 31 31 31 31 31 31 31 31 31 31 31 31 31
31 31 31 31 31 31 31 36 37 77 32 32 32 32 32 32 69 68 31 31 69 69 68 31 31 69 35 31 31 31 31 31 31 31 31 31 31 31 31 31 31 
31 31 31 31 31 31 31 36 37 77 31 31 31 31 32 32 32 68 31 31 32 32 68 31 31 75 35 31 31 31 31 31 31 31 31 31 31 31 31 31 31
31 31 31 31 31 31 31 36 37 77 32 32 32 32 32 32 69 31 31 31 69 69  31 31 31 69 35 31 31 31 31 31 31 31 31 31 31 31 31 31 31
31 31 31 31 31 31 31 36 37 79 31 31 31 31 32 32 32 69 32 69 32 32 69 32 69 75 35 31 31 31 31 31 31 31 31 31 31 31 31 31 31
31 31 31 31 31 31 31 36 37 77 32 32 32 32 32 32 32 32 32 32 32 32 32 32 32 75 35 31 31 31 31 31 31 31 31 31 31 31 31 31 31
31 31 31 31 31 31 31 36 37 71 73 73 73 73 73 73 73 73 73 73 73 73 73 73 73 76 35 31 31 31 31 31 31 31 31 31 31 31 31 31 31
31 31 31 31 31 31 31 40 34 34 34 43 34 34 42 34 34 43 34 34 42 34 34 43 34 34 41 31 31 31 31 31 31 31 31 31 31 31 31 31 31
31 31 31 31 31 31 31 31 31 31 31 31 31 31 31 31 31 31 31 31 31 31 31 31 31 31 31 31 31 31 31 31 31 31 31 31 31 31 31 31 31
31 31 31 31 31 31 31 31 31 31 31 31 31 31 31 31 31 31 31 31 31 31 31 31 31 31 31 31 31 31 31 31 31 31 31 31 31 31 31 31 31
31 31 31 31 31 31 31 31 31 31 31 31 31 31 31 31 31 31 31 31 31 31 31 31 31 31 31 31 31 31 31 31 31 31 31 31 31 31 31 31 31
31 31 31 31 31 31 31 31 31 31 31 31 31 31 31 31 31 31 31 31 31 31 31 31 31 31 31 31 31 31 31 31 31 31 31 31 31 31 31 31 31
31 31 31 31 31 31 31 31 31 31 31 31 31 31 31 31 31 31 31 31 31 31 31 31 31 31 31 31 31 31 31 31 31 31 31 31 31 31 31 31 31
31 31 31 31 31 31 31 31 31 31 31 31 31 31 31 31 31 31 31 31 31 31 31 31 31 31 31 31 31 31 31 31 31 31 31 31 31 31 31 31 31
31 31 31 31 31 31 31 31 31 31 31 31 31 31 31 31 31 31 31 31 31 31 31 31 31 31 31 31 31 31 31 31 31 31 31 31 31 31 31 31 31
31 31 31 31 31 31 31 31 31 31 31 31 31 31 31 31 31 31 31 31 31 31 31 31 31 31 31 31 31 31 31 31 31 31 31 31 31 31 31 31 31
 