41 30 
0 0
3  1  1  11 1  1  1  15 14 1  3  1  1  1  3  1  1  1  3  1  1  1  3  1  1  1  1  1  1  1  15 14 1  1  1  1  1  1  1  1  1 
11 1  1  11 1  1  1  15 14 1  11 1  1  1  1  1  1  1  1  1  1  1  1  1  1  1  1  1  1  1  15 14 1  1  1  1  1  1  1  2  1
3  1  1  11 2  1  1  15 14 1  11 1  1  1  1  1  1  1  1  1  1  1  1  1  1  1  21 1  21 1  15 14 1  1  1  1  1  1  2  1  1 
1  1  1  11 2  2  1  15 14 1  27 11 11 11 11 11 11 1  27 11 11 11 11 11 11 1  11 1  11 1  15 14 1  1  1  1  1  1  2  1  1
3  1  1  11 1  2  2  15 14 1  11 1  1  1  1  1  11 1  11 1  1  1  1  1  11 1  21 1  21 1  15 14 1  1  1  1  2  1  1  1  1
1  1  1  11 2  2  2  15 14 1  11 1  1  1  1  1  11 1  11 1  1  1  1  1  11 1  11 1  11 1  15 14 1  2  1  2  1  2  1  2  1 
3  1  1  11 2  2  2  15 14 1  11 1  1  1  1  1  11 1  11 1  1  1  1  1  11 1  21 1  21 1  15 14 2  2  2  1  1  1  1  1  1
11 1  1  11 1  2  1  15 14 1  11 1  1  1  1  1  11 1  11 1  1  1  1  1  11 1  11 1  11 1  15 14 1  2  1  1  1  2  2  2  1
11 1  1  11 1  2  1  15 14 1  11 11 11 11 11 11 11 1  11 11 11 11 11 11 11 1  21 1  21 1  15 14 1  1  2  2  1  2  1  2  1
11 11 11 11 1  1  1  15 14 1  11 11 11 22 22 22 11 1  11 11 11 22 22 22 11 1  11 1  11 1  15 14 1  1  1  1  2  1  1  1  1
11 11 11 11 1  1  1  15 14 1  1  1  1  29 22 28 1  1  1  1  1  29 22 28 1  1  1  1  1  1  15 14 1  1  2  2  2  1  1  1  1 
1  1  1  1  1  1  23 15 14 24 1  1  1  29 22 28 1  1  1  1  1  29 22 28 1  1  1  1  1  23 15 14 24 1  1  1  1  1  1  1  1
12 12 12 12 12 12 12 22 22 12 12 12 12 12 22 12 12 12 12 12 12 12 22 12 12 12 12 12 12 12 22 22 12 12 12 12 12 12 12 12 12
13 13 13 13 13 13 13 22 22 13 13 13 13 13 13 13 13 13 13 13 13 13 13 13 13 13 13 13 13 13 13 13 13 13 13 13 13 13 13 13 13
3  11 11 11 1  1  25 15 14 26 2  2  1  1  1  1  1  1  1  1  2  1  1  1  1  1  1  1  2  2  1  1  1  2  2  1  1  64 64 1  1 
1  1  1  11 1  1  1  15 14 2  2  2  1  1  1  2  2  1  1  1  2  2  1  1  1  1  1  1  1  2  2  1  1  2  1  2  1  64 64 1  1
3  1  1  11 1  1  1  15 14 2  2  2  1  1  1  1  1  1  1  1  2  1  30 11 11 11 11 11 11 11 11 11 11 11 11 11 1  64 64 1  1
1  1  1  11 1  21 1  15 14 2  2  1  1  27 11 11 11 11 11 11 1  1  11 1  1  1  1  1  1  1  1  1  1  1  1  11 1  64 64 1  1
3  1  1  11 1  11 1  15 14 1  1  1  1  11 11 1  1  1  11 11 1  1  11 1  1  1  1  1  1  1  1  1  1  1  1  11 1  64 64 1  1
1  1  1  11 1  21 1  15 14 1  1  1  1  11 11 1  1  1  11 11 1  1  11 32 32 32 32 32 32 32 32 32 32 32 32 11 1  64 64 2  1 
3  1  1  11 1  11 1  15 14 1  1  1  1  11 11 1  1  1  11 11 1  1  11 32 32 32 32 32 32 32 32 32 32 32 32 11 1  64 64 2  1
1  1  1  11 1  21 1  15 14 1  1  2  1  11 11 11 11 11 11 11 2  2  11 32 32 11 11 11 32 32 32 11 11 32 32 11 1  64 64 1  2
3  1  11 11 1  11 1  15 14 1  2  2  1  11 11 11 11 11 11 11 1  2  11 11 11 22 22 22 11 11 22 22 22 11 11 11 1  64 64 2  2
1  1  11 11 1  21 1  15 14 1  2  1  1  11 11 11 22 22 22 11 1  1  1  1  1  29 22 28 1  1  29 22 28 1  1  1  1  64 64 1  1
3  1  11 11 1  11 1  15 14 1  1  1  1  2  1  1  29 22 28 1  1  2  1  1  1  29 22 28 1  1  29 22 28 1  2  2  1  64 64 1  1
1  1  11 11 1  1  1  15 14 1  1  1  2  2  2  1  29 22 28 1  1  2  2  1  1  29 22 28 2  2  29 22 28 1  1  2  1  64 64 1  1
3  1  11 11 1  1  1  15 14 1  1  1  1  2  1  1  29 22 28 1  1  1  1  1  1  29 22 28 1  1  29 22 28 1  1  1  1  64 64 1  1
1  1  11 11 1  2  1  15 20 12 12 12 12 12 12 12 12 22 12 12 12 12 12 12 12 12 22 12 12 12 12 22 12 12 12 12 12 12 12 12 12
3  1  11 11 1  1  2  18 13 13 13 13 13 13 13 13 13 13 13 13 13 13 13 13 13 13 13 13 13 13 13 13 13 13 13 13 13 13 13 13 13
3  3  11 9  1  9  1  9  1  9  1  9  1  9  1  9  1  9  1  9  1  9  1  9  1  9  1  9  1  9  1  9  1  9  1  9  1  9  1  3  3
3  3  11 11 11 11 11 11 11 11 11 11 11 11 11 11 11 11 11 11 11 11 11 11 11 11 11 11 11 11 11 11 11 11 11 11 11 11 11 11 11