41 30 
0 0
3  1  3  1  3  1  3  1  3  1  3  1  3  1  3  1  3  1  3  1  3  1  3  1  3  1  3  1  3  1  3  1  3  1  3  1  3  1  3  1  3
1  3  1  3  1  3  1  3  1  1  1  1  1  1  1  1  1  1  1  1  1  3  1  3  1  3  1  3  1  3  1  3  1  3  1  3  1  3  1  3  1  
3  1  3  1  3  1  3  1  1  1  1  1  1  1  1  1  1  1  1  1  1  1  3  1  3  1  3  1  3  1  3  1  3  1  3  1  3  1  3  1  3
1  3  11 3  11 3  11 11 11 11 11 11 11 11 11 11 11 11 11 1  1  1  1  3  1  3  1  3  1  3  1  3  1  3  1  3  1  3  1  3  1
3  1  3  11 3  11 3  11 11 11 11 11 11 11 11 11 11 11 11 11 11 11 11 11 3  11 3  11 3  11 3  11 3  11 3  11 3  11 3  11 3
1  3  1  3  1  3  1  1  11 11 1  1  1  1  1  1  1  1  1  1  1  1  1  3  1  3  1  3  1  3  1  3  1  3  1  3  1  3  1  3  1
3  1  3  1  3  1  3  1  1  11 1  1  27 11 11 11 11 11 11 1  1  1  1  11 3  1  3  1  3  1  3  1  3  1  3  1  3  1  3  1  3 
1  3  1  3  1  3  1  1  11 11 1  1  11 1  1  1  1  1  11 1  1  1  1  11 1  3  1  3  11 3  1  3  1  3  1  3  1  3  1  3  1
3  1  3  1  3  1  3  1  1  11 1  1  11 1  1  1  1  1  11 1  1  1  1  11 1  1  1  1  11 11 3  1  3  1  3  1  3  1  3  1  3 
1  3  1  3  1  3  11 11 11 11 1  1  11 1  1  1  1  1  11 1  1  1  1  11 1  1  1  1  11 11 11 3  1  3  1  3  1  3  1  3  1
3  1  3  1  3  1  3  11 11 11 1  1  11 1  1  1  1  1  11 1  1  1  1  1  11 1  11 11 11 11 11 1  3  1  3  1  3  1  3  1  3 
1  3  1  3  1  3  1  1  1  11 1  1  11 1  1  11 11 11 11 1  1  1  1  1  2  11 1  11 1  11 11 3  1  3  1  3  1  3  1  3  1
3  1  3  1  3  1  3  1  3  11 1  1  11 11 11 22 22 22 11 1  1  1  1  1  2  2  2  2  2  2  11 11 3  1  3  1  3  1  3  1  3 
1  3  1  3  1  3  1  3  1  3  11 11 11 1  1  64 64 64 1  1  1  1  1  1  1  2  2  2  2  2  2  11 1  3  1  3  1  3  1  3  1
3  1  3  1  3  1  3  1  3  1  3  11 11 11 1  1  64 64 64 1  1  1  1  1  1  2  2  2  2  2  2  11 1  1  3  1  3  1  3  1  3 
1  3  1  1  1  1  1  3  1  3  1  3  11 11 11 1  64 64 64 64 1  1  1  1  1  1  2  2  2  2  2  11 1  3  1  3  1  3  1  3  1
3  1  3  1  1  1  1  1  3  1  3  1  3  11 11 11 1  64 64 64 1  1  1  1  1  1  2  2  2  2  2  2  11 1  3  1  3  1  3  1  3 
1  3  1  11 1  1  1  3  1  3  1  3  11 11 11 11 1  1  64 64 64 1  1  1  1  1  1  2  2  2  2  2  2  11 1  3  1  3  1  3  1
3  1  1  1  11 11 11 1  3  1  3  1  3  11 11 11 1  64 64 64 64 1  1  1  1  1  1  1  2  2  2  2  2  11 3  1  3  1  3  1  3 
11 1  1  1  11 1  1  11 1  1  1  3  11 11 11 11 1  64 64 64 64 1  1  1  1  1  1  1  1  1  2  2  2  3  1  3  1  3  1  3  1
11 1  11 11 11 1  1  11 1  1  1  1  11 11 11 11 1  64 64 64 64 64 1  1  1  1  1  1  1  1  1  1  3  1  3  1  3  1  3  1  3 
11 11 11 11 1  1  1  11 1  11 1  1  11 11 11 11 1  64 64 64 64 64 1  2  2  1  1  1  1  1  1  1  11 3  1  3  1  3  1  3  1
11 1  1  1  1  1  1  1  11 11 11 1  11 11 11 1  64 64 64 64 64 2  2  2  2  2  1  1  1  1  1  1  3  1  3  1  3  1  3  1  3 
11 1  1  1  1  1  1  1  1  1  1  11 1  1  64 64 64 64 64 64 2  2  2  2  2  2  2  1  1  1  1  1  11 3  1  3  1  3  1  3  1
1  1  1  1  1  1  1  64 64 1  1  1  1  64 64 64 64 64 64 64 2  2  2  2  2  2  2  1  1  1  1  1  3  1  3  1  3  1  3  1  3 
12 12 12 12 12 12 12 22 64 64 64 64 64 64 64 64 64 64 64 64 2  2  2  2  2  2  2  2  1  1  1  1  11 3  1  3  1  3  1  3  1
13 13 13 13 13 13 52 14 64 64 64 64 64 64 64 64 64 64 2  2  2  2  2  2  2  2  2  2  1  1  1  1  3  1  3  1  3  1  3  1  3 
1  1  1  1  1  1  15 14 1  64 64 64 64 64 64 64 64 2  2  2  2  2  2  2  2  2  2  2  1  1  1  3  11 3  1  3  1  3  1  3  1
1  1  1  1  1  1  15 14 1  1  1  64 64 64 64 1  1  2  2  2  2  2  2  2  2  2  2  1  1  1  3  1  3  1  3  1  3  1  3  1  3 
1  1  1  1  1  1  15 14 1  1  1  1  1  1  1  1  1  1  2  2  2  2  2  2  2  2  1  1  1  3  1  3  1  3  1  3  1  3  1  3  1
1  1  1  1  1  1  15 14 1  1  1  1  1  1  1  1  1  1  1  1  1  1  1  1  1  1  3  1  3  1  3  1  3  1  3  1  3  1  3  1  3 