41 30 
0 0
1  1  1  1  1  1  15 14 1  1  1  1  1  1  1  1  1  1  1  1  1  1  1  1  1  1  3  1  3  1  3  1  3  1  3  1  3  1  3  1  3 
1  1  1  1  1  1  15 14 1  1  1  1  1  1  1  1  1  1  1  1  1  1  1  1  1  1  11 3  1  3  1  3  1  3  1  3  1  3  1  3  1
1  1  1  1  1  1  15 14 1  1  2  2  2  2  2  1  1  1  1  1  1  1  1  1  1  1  11 11 3  1  3  1  3  1  3  1  3  1  3  1  3 
1  1  1  1  1  23 15 14 1  1  2  1  2  1  1  2  1  1  1  2  1  1  1  2  1  1  11 11 1  3  1  1  1  3  1  3  1  3  1  3  1
1  1  1  1  1  15 22 19 1  1  2  1  2  1  1  2  1  1  2  1  2  1  2  1  1  1  11 11 11 1  11 3  3  1  3  1  3  1  3  1  3
1  1  1  1  1  15 14 26 1  1  2  1  2  1  1  2  1  1  1  1  1  2  1  1  1  1  1  11 11 3  11 1  1  3  1  3  1  3  1  3  1 
1  1  1  1  1  15 14 1  1  1  2  1  2  2  2  1  1  1  1  1  1  2  1  1  1  1  1  1  11 11 3  11 3  1  3  1  3  1  3  1  3
1  1  1  1  23 15 14 1  1  1  2  1  2  1  1  2  1  1  1  1  1  2  1  1  1  1  1  1  1  11 1  3  1  3  1  3  1  3  1  3  1
1  1  1  1  16 22 14 1  1  1  2  1  2  1  1  2  1  1  1  1  1  2  1  1  1  1  1  1  1  11 1  11 3  11 3  1  3  1  3  1  3
1  1  1  23 15 22 24 1  1  1  2  1  2  1  1  2  1  1  1  1  1  2  1  1  1  1  1  1  1  1  11 11 11 11 11 3  1  3  1  3  1
1  1  1  16 22 19 26 1  1  1  2  2  2  2  2  1  1  1  1  1  1  2  1  1  1  1  1  1  1  1  11 1  11 11 3  1  3  1  3  1  3
1  23 16 22 19 1  1  1  1  1  1  1  1  1  1  1  1  1  1  1  1  1  1  1  1  1  1  1  1  1  1  1  11 11 11 3  1  3  1  3  1
12 12 22 19 1  1  1  1  1  1  1  1  1  1  1  1  1  1  1  1  1  1  1  1  1  1  1  1  1  1  1  1  11 1  11 11 3  1  3  1  3
13 13 19 1  1  1  2  2  2  1  1  1  1  1  1  1  1  1  1  1  1  1  1  1  1  1  1  1  1  1  1  1  1  1  11 3  11 3  1  3  1
1  1  1  1  1  1  2  1  2  1  1  1  1  1  1  1  1  1  1  1  1  1  1  1  1  1  1  1  1  1  1  1  21 1  11 11 3  1  3  1  3 
1  1  1  1  1  1  2  1  2  1  1  1  1  1  1  1  1  1  1  1  1  1  1  1  1  2  1  2  1  1  1  1  11 1  1  3  11 3  1  3  1
1  1  1  1  1  1  2  1  2  1  1  2  2  2  1  1  2  1  2  2  1  1  1  2  2  2  1  2  2  2  2  2  21 1  1  11 3  1  3  1  3
1  1  1  1  1  1  2  1  2  1  2  1  1  1  2  1  2  2  1  1  2  1  2  1  1  1  1  1  2  1  1  1  11 1  1  3  1  3  1  3  1
1  1  1  1  1  1  2  1  2  1  2  1  1  1  2  1  2  1  1  2  1  2  1  1  2  1  1  1  2  2  1  1  1  1  1  11 3  1  3  1  3
1  1  1  1  1  1  2  1  2  1  2  1  1  1  2  1  2  1  1  1  1  2  1  1  1  2  1  1  2  1  1  1  1  1  1  3  11 3  1  3  1 
1  1  1  2  1  1  2  1  2  1  2  1  1  1  2  1  2  1  1  1  1  1  2  1  1  2  1  1  2  1  1  2  2  1  1  11 3  1  3  1  3
1  1  1  1  2  2  2  2  1  1  1  2  2  2  1  1  2  1  1  1  1  1  1  2  2  1  1  1  2  2  2  1  1  1  1  3  11 3  1  3  1
1  1  1  1  1  1  1  1  1  1  1  1  1  1  1  1  1  1  1  1  1  1  1  1  1  1  1  1  1  1  1  1  1  1  1  11 3  1  3  1  3
1  1  1  1  1  1  1  1  1  1  1  1  1  1  1  1  1  1  1  1  1  1  1  1  1  1  1  1  1  1  2  2  2  2  2  3  1  3  1  3  1
1  1  1  1  1  1  1  1  1  2  1  1  1  1  1  1  1  1  1  1  1  1  1  1  1  1  1  1  1  2  2  2  2  2  2  11 3  1  3  1  3
1  1  1  1  1  1  1  1  2  2  1  1  1  2  2  1  1  1  1  1  1  1  1  1  1  1  1  1  1  2  2  2  2  2  2  3  1  3  1  3  1
1  1  1  1  1  1  1  1  1  2  2  1  1  1  2  2  1  1  1  1  1  1  1  1  1  1  1  1  1  2  2  2  2  2  3  1  3  1  3  1  3
12 12 12 12 12 12 12 12 12 12 12 12 12 12 12 12 12 12 17 1  2  2  1  1  1  1  1  1  1  2  2  2  2  3  1  3  1  3  1  3  1
13 13 13 13 13 13 13 13 13 13 13 13 13 13 13 13 13 13 19 1  2  1  1  1  1  11 3  11 3  1  3  1  3  1  3  1  3  1  3  1  3
3  3  1  9  1  9  1  9  1  9  1  9  1  9  1  9  1  9  1  9  1  9  11 9  11  9 11 9  11 9  1  9  1  9  1  9  1  9  1  3  1
3  3  11 11 11 11 11 11 11 11 11 11 11 11 11 11 11 11 11 11 11 11 11 11 11 11 11 9  1  9  1  9  1  9  1  9  1  9  1  3  3