41 30 
0 0
3  1  1  3  1  3  1  3  1  3  1  3  1  3  1  3  1  3  1  3  1  3  1  3  1  3  1  3  1  3  1  3  1  3  1  3  1  3  1  3  1
1  1  1  1  1  1  1  1  1  1  1  1  1  1  1  1  1  1  1  1  1  1  1  1  1  1  1  1  1  1  1  1  3  1  3  1  3  1  3  1  3  
3  1  1  1  1  1  1  1  1  1  1  1  1  1  1  1  1  1  1  1  1  1  1  1  1  1  1  1  1  1  1  1  1  3  1  3  1  3  1  3  1
1  11 11 11 11 11 11 11 11 11 11 11 11 11 11 11 11 11 11 1  1  1  1  1  1  1  1  1  1  1  1  1  1  1  3  1  3  1  3  1  3
3  11 11 11 11 11 11 11 11 11 11 11 11 11 11 11 11 11 11 11 11 11 11 11 11 11 11 11 11 11 11 11 11 11 11 3  11 3  11 3  11
1  1  1  11 1  1  1  1  1  1  1  1  1  1  1  1  1  1  1  1  1  1  1  1  1  1  1  1  1  1  1  1  11 11 11 11 3  1  3  1  3 
3  1  1  11 1  1  1  1  1  1  1  1  1  1  1  1  1  1  1  1  1  1  1  1  1  1  1  1  1  1  1  1  1  11 11 11 11 3  1  3  1
11 1  1  11 1  1  1  1  1  1  1  1  1  1  1  1  1  1  1  1  1  1  1  1  1  1  1  1  1  1  1  1  1  11 11 11 11 1  3  1  3
3  1  1  11 1  1  1  16 12 12 12 12 12 12 12 12 12 12 12 12 12 12 12 12 12 12 12 12 12 12 12 17 24 1  11 11 11 1  1  3  1
11 11 11 11 1  1  1  15 51 13 13 13 13 13 13 13 13 13 13 13 13 13 13 13 13 13 13 13 13 13 52 22 12 12 17 1  11 1  3  1  3
3  1  1  11 1  1  1  15 14 53 11 11 1  1  1  11 11 64 28 1  1  1  1  1  1  1  1  1  1  1  18 13 13 52 14 1  1  11 1  3  1 
1  1  1  11 1  1  1  15 14 11 11 11 1  1  1  11 11 64 28 1  1  1  1  55 56 56 57 1  1  1  1  1  1  15 14 24 1  11 3  1  3
3  1  1  11 1  1  1  15 14 11 11 1  1  1  1  1  11 64 28 1  55 56 56 59 59 59 59 56 56 56 57 1  1  15 22 17 1  3  1  3  1
1  1  1  11 1  1  1  15 14 11 11 1  1  1  1  1  11 64 28 1  58 59 59 59 59 59 59 59 59 59 60 1  1  15 22 14 1  11 3  1  3
3  1  1  11 1  1  1  15 14 1  1  54 1  1  1  1  15 64 28 1  58 59 59 59 59 59 59 59 59 59 60 1  1  18 52 14 1  3  1  3  1 
1  1  1  11 1  1  1  15 14 1  1  1  1  1  1  1  15 64 28 55 59 59 59 59 59 59 59 59 59 59 60 1  1  1  15 14 1  11 3  1  3
3  1  1  11 1  1  1  15 14 1  1  1  11 11 1  1  15 64 28 58 59 59 59 59 59 59 59 59 59 59 59 57 1  1  15 14 1  11 11 3  1
1  1  1  11 1  1  1  15 14 1  1  1  11 11 1  1  15 64 28 58 59 59 59 59 59 59 59 59 59 59 59 60 1  1  15 14 1  11 11 1  3
3  1  1  11 1  1  1  15 14 1  1  1  1  1  1  1  15 64 28 58 59 59 59 59 59 59 59 59 59 59 59 60 1  1  15 14 1  11 11 3  1
1  1  1  11 1  1  1  15 14 1  1  1  1  1  1  1  15 64 28 58 59 59 59 59 59 59 59 59 59 59 59 60 1  1  15 14 1  1  11 11 3 
3  1  1  11 1  1  1  15 14 1  1  1  1  1  1  1  15 64 28 61 59 59 59 59 59 59 59 59 59 59 59 60 1  1  15 14 1  1  1  11 1
1  1  1  11 1  1  1  15 14 11 1  1  1  1  1  1  11 64 28 1  58 59 59 59 59 59 59 59 59 59 59 63 1  1  15 14 1  1  1  11 1
3  1  11 11 1  1  1  15 14 11 1  1  1  1  1  1  11 64 28 1  61 62 62 62 62 62 62 62 62 62 63 1  1  23 15 14 1  1  1  11 11
1  1  11 11 1  1  1  15 14 11 11 1  1  1  1  11 11 64 28 1  1  1  1  1  1  1  1  1  1  1  1  1  1  16 22 22 17 24 1  1  1
3  1  11 11 1  1  1  15 14 11 11 1  1  1  1  11 11 64 28 1  1  1  1  1  1  1  1  1  1  1  1  1  23 15 22 22 22 17 24 1  1 
1  1  11 11 1  1  1  15 22 12 12 12 12 12 12 12 12 22 12 12 12 12 12 12 12 12 12 12 12 12 12 12 12 22 22 22 22 22 12 12 12 
3  1  11 11 1  1  1  15 22 13 13 13 13 13 13 13 13 13 13 13 13 13 13 13 13 13 13 13 13 13 22 22 13 13 13 13 13 13 13 13 13
1  1  11 11 1  1  1  15 14 26 1  1  1  1  1  1  1  1  1  1  1  1  1  1  1  1  1  1  1  25 15 14 26 1  1  1  1  1  1  1  1
3  1  11 11 1  1  1  15 14 1  44 45 45 45 45 45 45 45 45 45 45 45 45 45 45 45 45 45 46 1  15 14 1  1  1  1  1  1  1  1  1
1  1  11 11 1  1  1  15 14 1  11 1  11 11 11 11 11 11 11 11 11 11 11 11 11 11 11 11 11 1  15 14 1  1  1  1  1  1  1  1  1
3  3  11 11 1  1  1  15 14 1  11 1  11 11 11 11 11 11 11 11 11 11 11 11 11 11 11 11 11 1  15 14 1  1  1  1  1  1  1  1  1