41 30 
0 0
3  1  1  3  1  3  1  3  1  3  1  3  1  3  1  3  1  3  1  3  1  3  1  3  1  3  1  3  1  3  3  1  7  7  6  1  7  8  1  3  3
1  1  1  1  1  1  1  1  1  1  1  1  1  1  1  1  1  1  1  1  1  1  1  1  1  1  1  1  1  1  1  1  7  7  1  1  7  7  1  1  1  
3  1  1  1  1  1  1  1  1  1  1  1  1  1  1  1  1  1  1  3  1  3  1  1  1  1  1  1  1  1  1  1  1  7  5  1  7  7  1  3  3
1  11 11 11 11 11 11 11 11 11 11 11 11 11 11 11 11 11 11 1  1  1  1  1  1  1  1  1  1  1  1  1  1  11 4  11 11 11 1  1  1
3  11 11 11 11 11 11 11 11 11 11 11 11 11 11 11 11 11 11 3  1  3  1  1  11 11 11 11 11 11 11 11 11 1  1  1  1  1  11 3  3
1  11 11 11 1  1  1  1  1  1  1  1  1  1  1  1  1  1  1  11 1  1  1  1  11 1  0  0  0  0  0  0  0  0  1  1  1  0  0  11 1
3  1  1  11 1  1  1  1  1  1  1  1  1  1  1  1  1  1  1  3  1  3  1  1  11 1  1  1  0  0  0  0  0  1  1  1  1  0  0  3  3
1  1  1  11 1  1  1  1  1  1  1  1  1  1  1  1  1  1  1  11 1  1  1  1  11 1  1  1  1  1  1  1  1  1  1  1  0  0  0  11 1
3  1  1  11 1  1  1  1  1  1  1  1  1  1  1  1  1  1  1  3  1  3  1  1  11 1  1  1  1  1  1  1  1  1  1  1  1  0  0  3  3
1  1  1  11 1  1  1  1  1  1  1  1  1  1  1  1  1  1  1  11 1  1  1  1  11 1  1  1  1  1  1  1  1  1  1  1  1  0  0  11 1
3  1  1  11 1  1  1  1  1  2  2  2  1  1  1  1  1  1  1  3  1  3  1  1  11 1  1  1  1  1  1  1  1  1  1  1  1  1  0  3  3
1  1  1  11 1  1  1  1  2  2  2  2  2  1  1  1  1  1  1  11 1  1  1  1  11 1  1  1  1  1  1  1  1  1  1  1  1  1  1  11 1
3  1  1  11 1  1  1  1  2  2  2  2  2  1  1  1  1  1  1  11 1  3  1  1  11 1  1  1  1  1  1  1  1  1  1  1  1  1  1  3  3
1  1  1  11 1  1  1  1  2  2  2  2  2  1  1  1  1  1  1  11 1  1  1  1  11 1  1  1  1  1  1  1  1  1  1  1  1  1  1  11 1
3  1  1  11 1  1  1  1  1  2  2  2  1  1  1  1  1  1  1  11 11 1  1  1  11 1  1  1  1  1  1  1  1  1  1  1  1  1  1  3  3
1  1  1  11 1  1  1  1  1  1  1  1  1  1  1  1  1  1  1  1  1  11 1  1  11 1  1  1  1  1  1  1  1  1  1  1  1  1  1  11 1
3  1  1  11 1  1  1  1  1  1  1  1  1  1  1  1  1  1  1  1  1  11 11 11 11 1  1  1  1  1  1  1  1  1  1  1  1  1  1  3  3
1  1  1  11 1  1  1  1  1  9  1  1  1  1  1  1  1  1  1  1  1  1  1  1  1  1  1  1  1  1  1  1  1  1  1  1  1  1  1  11 1
3  1  1  11 1  1  1  9  1  1  1  9  1  1  1  1  1  1  1  1  1  1  1  1  1  1  1  1  1  1  1  1  9  1  1  1  1  1  1  3  3
1  1  1  11 1  1  1  1  1  10 11 11 11 1  1  1  1  1  1  1  1  1  1  1  1  1  1  1  1  1  1  1  1  1  1  1  1  1  1  11 1
3  1  1  11 1  1  1  10 11 1  1  10 11 11 11 1  1  1  1  1  1  1  1  1  1  1  1  1  1  1  1  1  10 11 11 11 1  1  1  3  3
1  1  1  11 1  1  1  11 1  3  1  11 11 11 11 1  1  1  1  1  1  1  1  1  1  1  1  1  1  1  1  1  11 11 11 11 1  1  1  11 1
3  1  1  11 1  1  1  11 1  1  1  11 11 11 11 1  1  1  1  1  1  1  1  1  1  1  1  1  1  1  1  1  11 11 11 11 1  1  1  3  3
1  1  1  11 1  1  1  11 11 11 11 1  1  1  1  1  1  1  1  1  1  1  1  1  1  1  1  2  2  1  1  1  1  1  1  1  1  1  1  11 1
3  1  1  11 1  1  1  1  1  1  1  1  1  1  1  1  1  1  1  1  1  1  1  1  1  1  2  2  2  2  1  1  1  1  1  1  1  1  1  3  3
1  1  1  11 1  1  1  1  1  1  1  1  1  1  1  1  1  1  1  1  1  1  1  1  1  1  2  2  2  2  1  1  1  1  1  1  1  1  1  11 1
3  1  1  11 1  1  1  1  1  1  1  1  1  1  1  1  1  1  1  1  1  1  1  1  1  1  1  2  2  1  1  1  1  1  1  1  1  1  1  3  3
1  1  1  11 1  1  1  1  1  1  1  1  1  1  1  1  1  1  1  1  1  1  1  1  1  1  1  1  1  1  1  1  1  1  1  1  1  1  1  11 1
3  3  1  9  1  9  1  9  1  9  1  9  1  9  1  9  1  9  1  9  1  9  1  9  1  9  1  9  1  9  1  9  1  9  1  9  1  9  1  3  3
1  1  1  1  11 11 11 11 11 11 11 11 11 11 11 11 11 11 11 11 11 11 11 11 11 11 11 11 11 11 11 11 11 11 11 11 11 11 11 11 11
3  3  1  3  11 3  1  3  1  3  1  3  1  3  1  3  1  3  1  3  1  3  1  3  1  3  1  3  1  3  1  3  1  3  1  3  1  3  1  3  3
